Exposant	Secteur	Pays	AI
Railee	Hospitality/Tourism/Travel	France	Not AI
Suzan AI	Banking/Finance/Insurance/Legal	France	Not AI
:probabl.	Software Development/Cloud services	France	Not AI
.lumen	Health	Romania	Not AI
áISPALISá	Banking/Finance/Insurance/Legal	France	Not AI
0260.ai	Consulting	Canada	Not AI
102-103	Software Development/Cloud services	France	Not AI
1836	Banking/Finance/Insurance/Legal	France	Not AI
1km a pied	Smart City/Building	France	Not AI
1POINT6	Information technologies	France	Not AI
20 Minutes	Media/Entertainment/Culture	France	AI
2CRSi	Industry	France	Not AI
2DS LAB	Software Development/Cloud services	France	Not AI
2Emotion	Software Development/Cloud services	France	Not AI
2tonnes	HR/Training/Education	France	AI
321	Consulting	France	Not AI
360Learning	HR/Training/Education	France	AI
365Talents	Software Development/Cloud services	France	Not AI
36Kr	Media/Entertainment/Culture	China	AI
37 WINE		France	Not AI
3D UTU	Smart City/Building	Ukraine	Not AI
4GIFT	Luxury/Fashion/Beauty	Italy	Not AI
4MedBox	Other	Netherlands	Not AI
50inTech	HR/Training/Education	France	AI
62 RUBY STREET	Software Development/Cloud services	France	Not AI
A Virtual	Consumer goods/Retail/E-commerce	South Korea	AI
A.V. Mapping	Media/Entertainment/Culture	Taiwan	AI
A2D Acquire to Decide	Software Development/Cloud services	France	Not AI
AALIA.TECH	Health	France	Not AI
ABAKA AI	Information technologies	Singapore	Not AI
Abilous	HR/Training/Education	France	AI
ABSOLUTE LABS	Marketing/Advertising/Communication	France	Not AI
Abundant Earth	Software Development/Cloud services	France	Not AI
Abyssale	Marketing/Advertising/Communication	France	Not AI
Academic Sight	Industry	Turkey	Not AI
AccesLibre	Government/Public institutions	France	Not AI
Acclime	Consulting	Australia	Not AI
ACCURE Battery Intelligence	Software Development/Cloud services	Germany	Not AI
ACHILLE SOLUTIONS	Banking/Finance/Insurance/Legal	France	Not AI
ACS Biotech	Health	France	Not AI
ACSES SOLUTIONS	Other	France	Not AI
Actronika	Other	France	Not AI
Actronika	Other	France	Not AI
ACTRONIKA	Other	France	Not AI
ACTUAL GROUP	Other	France	Not AI
ActuIA	Media/Entertainment/Culture	France	AI
Acuicy	Other	Canada	Not AI
ACWA ROBOTICS	Industry	France	Not AI
ADAM Aerospace	Cybersecurity/Defense	United States of America	Not AI
ADAPTIVE MEDIA France	HR/Training/Education	France	AI
ADARA	Information technologies	Cote dÕIvoire	Not AI
ADASTEC	Software Development/Cloud services	United States of America	Not AI
AdCreative.ai	Marketing/Advertising/Communication	France	Not AI
AddOptics	Consumer goods/Retail/E-commerce	Netherlands	AI
ADIM	Government/Public institutions	France	Not AI
Adlema	Industry	Turkey	Not AI
Adriel	Software Development/Cloud services	United States of America	Not AI
Advizeo	Energy	France	Not AI
Aectual	Other	Netherlands	Not AI
AeproMED Innovation corp.,Ltd.	Health	Taiwan	Not AI
AEQUO	Energy	France	Not AI
AER BFC (Agence Economique Regionale Bourgogne Franche Comte)	Government/Public institutions	France	Not AI
Aerialmetric	Industry	Madagascar	Not AI
Aeterlink Corp.	Smart City/Building	Japan	Not AI
Aevy	Energy	Norway	Not AI
AFFLUENCES	Mobility/Transportation	France	Not AI
Africa Smart Citizen	Smart City/Building	Senegal	Not AI
Africanews	Media/Entertainment/Culture	France	AI
AfricaTech Lab	Government/Public institutions	France	Not AI
AFTERDATA	Banking/Finance/Insurance/Legal	France	Not AI
AFTERDATA	Banking/Finance/Insurance/Legal	France	Not AI
AFX 54	Media/Entertainment/Culture	France	AI
AG Partners Publicis Africa	Media/Entertainment/Culture	France	AI
AG'EAU-VITAL	Industry	France	Not AI
AGENCE FR DE REALITE VIRTUELLE	Marketing/Advertising/Communication	France	Not AI
Agilauto Partage	Mobility/Transportation	France	Not AI
Aglae	Marketing/Advertising/Communication	France	Not AI
Agnavi	Food	Japan	Not AI
Agnavi Co. Ltd.,	Food	Japan	Not AI
Agnostiq	Software Development/Cloud services	Canada	Not AI
Agorize	Information technologies	France	Not AI
Agrable	Banking/Finance/Insurance/Legal	France	Not AI
AGRI LAB LEVERAGE	Food	France	Not AI
Agribanana	Industry	Cote dÕIvoire	Not AI
agriBORA	Food	Kenya	Not AI
AGRILOGIC SYSTeMES	Industry	New Caledonia	Not AI
AgroSustain	Food	Switzerland	Not AI
Agua de Sol SAS	Food	France	Not AI
aHRtemis	HR/Training/Education	France	AI
AI Avenue sponsored by Salesforce	Software Development/Cloud services	France	Not AI
AI Bright	Consumer goods/Retail/E-commerce	France	AI
AI BRIGHT	Consumer goods/Retail/E-commerce	France	AI
AI for Biogas	Energy	France	Not AI
AI SILK Corporation	Industry	Japan	Not AI
AI21 Labs	Software Development/Cloud services	Israel	Not AI
AI4MedImaging	Software Development/Cloud services	Portugal	Not AI
Ai4Privacy	Telecom/Connectivity	Switzerland	Not AI
AiiNTENSE	Health	France	Not AI
Ailive Inc.	Software Development/Cloud services	South Korea	Not AI
AILY LABS	Software Development/Cloud services	Germany	Not AI
AIMEDIS	Health	Netherlands	Not AI
Aimino Tech GmbH	Software Development/Cloud services	Germany	Not AI
AIMMO	Software Development/Cloud services	South Korea	Not AI
AINDO SPA	Information technologies	Italy	Not AI
AIPS Technology Co., Ltd.	Other	Taiwan	Not AI
AIRA Corporation	Smart City/Building	Taiwan	Not AI
Airalo	Hospitality/Tourism/Travel	Singapore	Not AI
Airbus	Mobility/Transportation	France	Not AI
Aircards & Metalitix	Consumer goods/Retail/E-commerce	United Kingdom	AI
AIRMO	Energy	Germany	Not AI
Airrange Software GmbH	Software Development/Cloud services	Germany	Not AI
Airtel	Telecom/Connectivity	Congo, the Democratic Republic	Not AI
Airudi	HR/Training/Education	Canada	AI
Airudit	Software Development/Cloud services	France	Not AI
Airwallex	Software Development/Cloud services	Australia	Not AI
AISTROSPACE	Information technologies	United Arab Emirates	Not AI
Aitenders	Software Development/Cloud services	France	Not AI
Aive	Marketing/Advertising/Communication	France	Not AI
AiVidens	Information technologies	Belgium	Not AI
AIZoPlan powered by iTransform365	Information technologies	France	Not AI
AKANTHAS	Smart City/Building	France	Not AI
AKIDAIA	Cybersecurity/Defense	France	Not AI
Ako	Luxury/Fashion/Beauty	France	Not AI
ALBERT IA	Government/Public institutions	France	Not AI
Alchimedics	Health	France	Not AI
Alcmeon	Software Development/Cloud services	France	Not AI
Aldoria	Industry	France	Not AI
ALEIA	Information technologies	France	Not AI
Alemca	Industry	France	Not AI
Algal Bio	Industry	Japan	Not AI
Algerian Startups Fund	Banking/Finance/Insurance/Legal	Algeria	Not AI
Algoritmi	Hospitality/Tourism/Travel	Japan	Not AI
ALGOS	Software Development/Cloud services	France	Not AI
AlgoTech	Health	France	Not AI
Alibaba Cloud	Software Development/Cloud services	China	Not AI
Alice & Bob	Information technologies	France	Not AI
ALICE & BOB	Information technologies	France	Not AI
Aligo AI	Marketing/Advertising/Communication	South Korea	Not AI
ALIOTHSYSTEM ENERGY	Energy	Burkina Faso	Not AI
All Good Energy Co., Ltd.	Energy	Taiwan	Not AI
Alliance Industrie du Futur	Non Profit	France	Not AI
AlloBrain		France	Not AI
AlloReview	Information technologies	France	Not AI
Alltheway	Software Development/Cloud services	France	Not AI
Allye Energy	Energy	United Kingdom	Not AI
Alp Valley	Information technologies	France	Not AI
ALPAY	Banking/Finance/Insurance/Legal	Algeria	Not AI
Alpha Recyclage Composites	Industry	France	Not AI
ALPHA10X	Banking/Finance/Insurance/Legal	France	Not AI
Alphabrain	Health	France	Not AI
Alphabrain	Health	France	Not AI
Altametris	Software Development/Cloud services	France	Not AI
Alterande	Industry	France	Not AI
ALTEVAX	Health	France	Not AI
ALTRANS Energies	Energy	France	Not AI
ALTYOR - STRATOS : MAKE IT! ACADEMY	Industry	France	Not AI
Always Support Technology Co., Ltd	Software Development/Cloud services	Taiwan	Not AI
AM3L	Industry	France	Not AI
AMATELUS Inc.	Media/Entertainment/Culture	Japan	AI
Amazon Web Services (AWS)	Software Development/Cloud services	United States of America	Not AI
AMD Products (China)Co.,Ltd.	Consumer goods/Retail/E-commerce	China	AI
Amiral Technologies	Industry	France	Not AI
AMK biotech	Health	France	Not AI
AMK Biotech	Health	France	Not AI
Amon AI	Smart City/Building	France	Not AI
AMPECO	Mobility/Transportation	Bulgaria	Not AI
AMPHITRITE	Mobility/Transportation	France	Not AI
amplify	Marketing/Advertising/Communication	Switzerland	Not AI
ANAE	Government/Public institutions	France	Not AI
ANALOGIES	Health	France	Not AI
ANAPIX medical	Health	France	Not AI
Anavid	Consumer goods/Retail/E-commerce	France	AI
anessa	Energy	Canada	Not AI
ANFR	Government/Public institutions	France	Not AI
Angel	Software Development/Cloud services	France	Not AI
Angel-start	Software Development/Cloud services	France	Not AI
Anod	Mobility/Transportation	France	Not AI
Anozr Way	Cybersecurity/Defense	France	Not AI
Anthropic	Information technologies	United States of America	Not AI
Antilogy	Consulting	France	Not AI
ANYOS	Mobility/Transportation	France	Not AI
Anywr	HR/Training/Education	France	AI
AP solution IO	Software Development/Cloud services	France	Not AI
APGAR	Consulting	France	Not AI
AppTweak	Marketing/Advertising/Communication	Belgium	Not AI
AQEMIA	Health	France	Not AI
AQEMIA	Health	France	Not AI
AquaTech Innovation	Industry	France	Not AI
AR Engineering	Software Development/Cloud services	United Arab Emirates	Not AI
AR[t] Studio	Media/Entertainment/Culture	France	AI
Arbiom	Food	France	Not AI
Arcadium esport	Media/Entertainment/Culture	France	AI
Archillys	Luxury/Fashion/Beauty	Japan	Not AI
ARCHIMAID	Smart City/Building	France	Not AI
Archireef	Other	Hong Kong	Not AI
Archireef	Other	United Arab Emirates	Not AI
Areix Analytics Limited	Information technologies	Taiwan	Not AI
ARGO	Marketing/Advertising/Communication	France	Not AI
Arianee	Information technologies	France	Not AI
Ark Wisdom Co., Ltd.	Media/Entertainment/Culture	Taiwan	AI
Armada	Media/Entertainment/Culture	France	AI
ARMENIA - Ministry of High-Tech Industry	Government/Public institutions	Armenia	Not AI
ARPINET LLC	Telecom/Connectivity	Armenia	Not AI
Art Confidential	Media/Entertainment/Culture	France	AI
Art&Fact Innovation	Telecom/Connectivity	France	Not AI
ART&FACT INNOVATION	Telecom/Connectivity	France	Not AI
ARTCENTRICA	Media/Entertainment/Culture	Italy	AI
arTech	Media/Entertainment/Culture	Guadeloupe	AI
Artefact	Consulting	France	Not AI
Artefact Open Innovation	Consulting	France	Not AI
Article 1	HR/Training/Education	France	AI
Artifeel	Smart City/Building	France	Not AI
Artifeel	Smart City/Building	France	Not AI
ArtinLeap	Information technologies	France	Not AI
ARTKOFA	Marketing/Advertising/Communication	France	Not AI
Artpoint	Media/Entertainment/Culture	France	AI
Arxy Future Lab s.a.r.l	Luxury/Fashion/Beauty	Luxembourg	Not AI
ARY	Consumer goods/Retail/E-commerce	France	AI
Aryballe	Industry	France	Not AI
ASE AG	Mobility/Transportation	Switzerland	Not AI
Ask for the moon	Software Development/Cloud services	France	Not AI
Asleep	Health	korearepublicof	Not AI
ASphere	HR/Training/Education	France	AI
Aster-X	Software Development/Cloud services	France	Not AI
Astha IT	Software Development/Cloud services	Bangladesh	Not AI
ASTRAKODE SRL	Software Development/Cloud services	Italy	Not AI
ASTRAN	Cybersecurity/Defense	France	Not AI
Astreas	Food	United States of America	Not AI
ASTRIIS	Industry	France	Not AI
asvin GmbH	Cybersecurity/Defense	Germany	Not AI
ateka|tx	Health	France	Not AI
Atekka	Banking/Finance/Insurance/Legal	France	Not AI
ATHICS	Information technologies	Italy	Not AI
AtmosGear	Consumer goods/Retail/E-commerce	France	AI
ATOFLOW	Media/Entertainment/Culture	New Caledonia	AI
Atopia	Media/Entertainment/Culture	Germany	AI
Atoptima	Software Development/Cloud services	France	Not AI
Au-Zone Technologies	Mobility/Transportation	Canada	Not AI
Audi	Mobility/Transportation	Germany	Not AI
AUDIO GUIDE PARIS	Hospitality/Tourism/Travel	France	Not AI
Augmented Brain Labs SA	Information technologies	Switzerland	Not AI
Augur	Industry	France	Not AI
AUMET	Software Development/Cloud services	France	Not AI
AURIZEO	Mobility/Transportation	France	Not AI
AUSHA	Marketing/Advertising/Communication	France	Not AI
Australia - Global Victoria	Government/Public institutions	Australia	Not AI
Authena	Information technologies	Switzerland	Not AI
AutoLex	Software Development/Cloud services	France	Not AI
Automatika	Software Development/Cloud services	France	Not AI
Autone	Software Development/Cloud services	France	Not AI
AUTONOMOUS	Information technologies	Saudi Arabia	Not AI
AUUM	Industry	France	Not AI
Ava Group	Industry	Australia	Not AI
Avalanche Computing Taiwan Inc.	Information technologies	Taiwan	Not AI
AVATAR MEDICAL	Health	France	Not AI
AVAtronics SA	Other	Switzerland	Not AI
AVES Reality	Cybersecurity/Defense	Germany	Not AI
AVES Reality	Mobility/Transportation	Germany	Not AI
AVOB	Smart City/Building	France	Not AI
AvoLingo	HR/Training/Education	Germany	AI
AVOMO VR	Media/Entertainment/Culture	France	AI
AWIT	Software Development/Cloud services	Belgium	Not AI
AWorld	Information technologies	Italy	Not AI
AXA	Banking/Finance/Insurance/Legal	France	Not AI
Axelera AI	Information technologies	Netherlands	Not AI
Axionable	Consulting	France	Not AI
Axys	Consulting	France	Not AI
Aydee	Luxury/Fashion/Beauty	France	Not AI
Aywajieune	Consumer goods/Retail/E-commerce	Senegal	AI
B in Touch	Information technologies	France	Not AI
b4value.net GmbH	Information technologies	Germany	Not AI
Baamtu	Software Development/Cloud services	Senegal	Not AI
Baback	Consumer goods/Retail/E-commerce	France	AI
Bactech	Cybersecurity/Defense	France	Not AI
Bamboo Energy	Energy	Spain	Not AI
Bambuser	Software Development/Cloud services	Sweden	Not AI
BARC	Consumer goods/Retail/E-commerce	South Korea	AI
Barreleye Inc.	Health	korearepublicof	Not AI
Barunbio Inc.	Luxury/Fashion/Beauty	South Korea	Not AI
BaseGun	Cybersecurity/Defense	France	Not AI
Batazia	Information technologies	Netherlands	Not AI
Batch	Marketing/Advertising/Communication	France	Not AI
Batiprint3D	Industry	France	Not AI
BAVARDISES	Personal Services	France	Not AI
Bavarian Startups	Government/Public institutions	Germany	Not AI
BAVERTIS	Mobility/Transportation	Germany	Not AI
BE ENERGY	Energy	France	Not AI
Beam AI	Information technologies	Germany	Not AI
Beam for music (Atrack)	Media/Entertainment/Culture	France	AI
BearingPoint	Consulting	France	Not AI
BEATERS	Luxury/Fashion/Beauty	France	Not AI
Beaunex Co., Ltd.	Luxury/Fashion/Beauty	korearepublicof	Not AI
Beaute INeE	Luxury/Fashion/Beauty	France	Not AI
BEEKAST	Other	France	Not AI
Beekee sarl	HR/Training/Education	Switzerland	AI
BeePlanet	Energy	Spain	Not AI
Beesiha	Health	Algeria	Not AI
BeestrO My French Paille a Croquer	Food	France	Not AI
Beev	Mobility/Transportation	France	Not AI
BEEWANT	Information technologies	France	Not AI
Beeway LMI	Mobility/Transportation	France	Not AI
BeFC	Energy	France	Not AI
BEFC	Energy	France	Not AI
BEHAV	Industry	France	Not AI
BEINK DREAM	Software Development/Cloud services	France	Not AI
Belgium	Government/Public institutions	Belgium	Not AI
Bellwether Industries	Mobility/Transportation	United Kingdom	Not AI
Bercy Hub	Government/Public institutions	France	Not AI
Beslogic	Information technologies	Canada	Not AI
Best Influence	Marketing/Advertising/Communication	France	Not AI
BestCase by ZWS GmbH	Software Development/Cloud services	Germany	Not AI
Beta.gouv.fr	Government/Public institutions	France	Not AI
BEWAI	Software Development/Cloud services	France	Not AI
BEWELLCOME	Health	France	Not AI
BeZero Carbon	Information technologies	United Kingdom	Not AI
BFM Business	Media/Entertainment/Culture	France	AI
BHOUT	Consumer goods/Retail/E-commerce	Portugal	AI
BHOUT	Consumer goods/Retail/E-commerce	Portugal	AI
Bia	Energy	Spain	Not AI
Bianor Group	Software Development/Cloud services	Bulgaria	Not AI
Bib batteries	Mobility/Transportation	France	Not AI
BIC - Business & Innovation Centre	Government/Public institutions	France	Not AI
Bifrost AI	Software Development/Cloud services	United States of America	Not AI
Bigbro.ai	Information technologies	United States of America	Not AI
BigProfiles	Software Development/Cloud services	Italy	Not AI
Bike Explo	Hospitality/Tourism/Travel	France	Not AI
Billiv	Consumer goods/Retail/E-commerce	France	AI
BIM FLOW	Smart City/Building	Tunisia	Not AI
BIMP	Software Development/Cloud services	Ukraine	Not AI
Binoloop	Information technologies	Canada	Not AI
BIOHAP	Industry	France	Not AI
Biomede	Food	France	Not AI
Biomemory	Software Development/Cloud services	France	Not AI
Biometrid	Information technologies	Portugal	Not AI
BIOMITECH	Smart City/Building	France	Not AI
Biomyc	Consumer goods/Retail/E-commerce	Bulgaria	AI
BIONIRS	Health	Argentina	Not AI
Bioptimus	Health	France	Not AI
BIOSOLVIT INDUSTRIA E COMeRCIO	Industry	Brazil	Not AI
Bioteos	Smart City/Building	France	Not AI
Biped	Health	Switzerland	Not AI
BIS - BUILDING INNOVATION SYSTEM	Smart City/Building	France	Not AI
Bistrochat	Hospitality/Tourism/Travel	Hong Kong	Not AI
BJIT LIMITED	Software Development/Cloud services	Bangladesh	Not AI
BK Fire	Other	Algeria	Not AI
BK ROBOTRONICS	Other	Algeria	Not AI
Black Fire ______	Industry	China	Not AI
Black Forest AI GmbH	Information technologies	Germany	Not AI
black-line	Other	France	Not AI
Blackfoot	Information technologies	France	Not AI
Blacknut Cloud Gaming	Media/Entertainment/Culture	France	AI
blackshark.ai	Other	Austria	Not AI
Blade Sense	Energy	France	Not AI
Blank	Banking/Finance/Insurance/Legal	France	Not AI
BLINK SOLUTION	Banking/Finance/Insurance/Legal	Algeria	Not AI
BLNG	Software Development/Cloud services	United States of America	Not AI
BLOKKUS	Cybersecurity/Defense	France	Not AI
Bloomflow	Software Development/Cloud services	France	Not AI
bloomUp	Consulting	Switzerland	Not AI
Blue Bees Therapeutics	Health	France	Not AI
Blue Frog Robotics	Other	France	Not AI
Blue Sky Energy Technology	Smart City/Building	Hong Kong	Not AI
Bluecrux	Information technologies	Belgium	Not AI
BLUENOSE	Industry	France	Not AI
BNP PARIBAS	Banking/Finance/Insurance/Legal	France	Not AI
Board of Cyber	Cybersecurity/Defense	France	Not AI
bodih	HR/Training/Education	France	AI
Bodyguard	Software Development/Cloud services	France	Not AI
Bolt Insight	Marketing/Advertising/Communication	Turkey	Not AI
BON VIVANT	Food	France	Not AI
Bondstein Technologies Limited	Information technologies	Bangladesh	Not AI
BOOKBOOKSHOP	HR/Training/Education	Cameroon	AI
Bordeaux Metropole	Government/Public institutions	France	Not AI
Borui	Marketing/Advertising/Communication	France	Not AI
BOUDI	Industry	France	Not AI
BOUYGUES	Smart City/Building	France	Not AI
BoxUp	Health	Switzerland	Not AI
BPartners IA	Software Development/Cloud services	France	Not AI
Bpifrance	Banking/Finance/Insurance/Legal	France	Not AI
Brain Station 23 PLC.	Software Development/Cloud services	Bangladesh	Not AI
Brain.	Cybersecurity/Defense	France	Not AI
Brain4Data	Information technologies	Germany	Not AI
BrainBox AI	Smart City/Building	Canada	Not AI
BrainBox AI	Energy	Canada	Not AI
Braincube	Software Development/Cloud services	France	Not AI
Brainfinger	Information technologies	France	Not AI
Braintale	Health	France	Not AI
BRANPER	Information technologies	Tunisia	Not AI
Bria Generative AI	Software Development/Cloud services	Israel	Not AI
Bria.ai	Software Development/Cloud services	United States of America	Not AI
BRIGHT	Marketing/Advertising/Communication	France	Not AI
British Embassy in Paris - UK Pavilion	Government/Public institutions	United Kingdom	Not AI
Bryanthings	Luxury/Fashion/Beauty	France	Not AI
BRYANTHINGS	Luxury/Fashion/Beauty	France	Not AI
bsurance	Banking/Finance/Insurance/Legal	Austria	Not AI
BT	Telecom/Connectivity	United Kingdom	Not AI
Builder.ai	Software Development/Cloud services	United Kingdom	Not AI
Bulgarian SME Promotion Agency	Government/Public institutions	Bulgaria	Not AI
Bunka	Software Development/Cloud services	France	Not AI
Business France	Government/Public institutions	France	Not AI
Business France - Innovation Outre-Mer	Government/Public institutions	France	Not AI
Business Insider	Media/Entertainment/Culture	United States of America	AI
Buster.Ai	Cybersecurity/Defense	France	Not AI
Butterfly XR	Health	France	Not AI
Button Hop	Software Development/Cloud services	France	Not AI
BYD FRANCE	Mobility/Transportation	France	Not AI
Bye Blues	Health	France	Not AI
BYOME LABS	Luxury/Fashion/Beauty	France	Not AI
BYSCO	Industry	France	Not AI
BZHunt	Cybersecurity/Defense	France	Not AI
C.S.T - Crime Science Technology	Cybersecurity/Defense	France	Not AI
C12	Information technologies	France	Not AI
C2MI		Canada	Not AI
Caast	Marketing/Advertising/Communication	France	Not AI
Cabinet Office / Government of Japan	Other	Japan	Not AI
CAIMI	Health	South Korea	Not AI
CALINESCENCE	Health	France	Not AI
Callendar	Industry	France	Not AI
Calypso AI	Information technologies	United States of America	Not AI
CAMION	Mobility/Transportation	Saudi Arabia	Not AI
Campus Cyber	Cybersecurity/Defense	France	Not AI
Camunda	Software Development/Cloud services	Germany	Not AI
Canada - Ambassade du Canada	Government/Public institutions	Canada	Not AI
Candam	Smart City/Building	Spain	Not AI
Caona Health	Health	Germany	Not AI
Cape	Cybersecurity/Defense	France	Not AI
CAPFLOW	Smart City/Building	Belgium	Not AI
CAPGEMINI	Consulting	France	Not AI
CAPSUL EVENTS	Marketing/Advertising/Communication	France	Not AI
Capsule Corp Labs			Not AI
Captain Blink	Mobility/Transportation	France	Not AI
CapTop S.r.l.	Energy	Italy	Not AI
CARAVEL By ImageImages	Hospitality/Tourism/Travel	France	Not AI
Carbon Energy. Inc	Energy	korearepublicof	Not AI
CarboneIO	Software Development/Cloud services	France	Not AI
Carbonplace	Software Development/Cloud services	United Kingdom	Not AI
CarbonScore	Software Development/Cloud services	France	Not AI
CareU	Health	Taiwan	Not AI
CARTOBIO	Government/Public institutions	France	Not AI
CartoDEBAT	Other	France	Not AI
Cassava Technologies	Telecom/Connectivity	United Kingdom	Not AI
CATALARM	Mobility/Transportation	France	Not AI
CAYTU	Software Development/Cloud services	Senegal	Not AI
CB NEWS	Media/Entertainment/Culture	France	AI
CCB GREENTECH	Industry	France	Not AI
CCI Paris Ile-de-France	Government/Public institutions	France	Not AI
CDOCCAZ	Consumer goods/Retail/E-commerce	France	AI
CEA	Government/Public institutions	France	Not AI
Ceercle	Consumer goods/Retail/E-commerce	France	AI
CEIA - AI Center of Excellence	HR/Training/Education	Brazil	AI
CEiSCAT	Health	France	Not AI
CELLAVEN	Other	France	Not AI
CellEmax	Health	France	Not AI
CellEmax	Health	France	Not AI
CENTILOC	Industry	France	Not AI
CentML	Software Development/Cloud services	Canada	Not AI
Centurio Esport	Media/Entertainment/Culture	France	AI
Cerenyi.ai	Information technologies	Canada	Not AI
Cereus Biosciences	Health	France	Not AI
Certainty Compliance	Consulting	Australia	Not AI
Cezigue	Mobility/Transportation	France	Not AI
Chainote	Banking/Finance/Insurance/Legal	France	Not AI
Chambre Franco-Allemande de Commerce et d'Industrie	Government/Public institutions	France	Not AI
Changing Dot	Software Development/Cloud services	France	Not AI
Chari	Banking/Finance/Insurance/Legal	Morocco	Not AI
Chat Legal.AI	Software Development/Cloud services	France	Not AI
Chata.ai	Information technologies	Canada	Not AI
ChatFAQ	Information technologies	Spain	Not AI
ChatLabs	Luxury/Fashion/Beauty	United States of America	Not AI
Chatlicense	Media/Entertainment/Culture	Netherlands	AI
Check & Visit	Smart City/Building	France	Not AI
CHINA EXPO	Other	France	Not AI
China Pavilion ___	Government/Public institutions	China	Not AI
CHIRON	Marketing/Advertising/Communication	Reunion	Not AI
CHITOSE	Industry	Japan	Not AI
Choose France	Government/Public institutions	France	Not AI
Choose Paris Region	Non Profit	France	Not AI
CHOUETTE	Other	France	Not AI
CHRISAYA - ESPRIT LeGER	Luxury/Fashion/Beauty	France	Not AI
CIC	Banking/Finance/Insurance/Legal	France	Not AI
CIRCLE	Mobility/Transportation	France	Not AI
Circu Li-ion S.A	Energy	Luxembourg	Not AI
CIRCUL'EGG	Food	France	Not AI
Circulae	Banking/Finance/Insurance/Legal	France	Not AI
CircularPlace	Software Development/Cloud services	France	Not AI
CircularPlace	Software Development/Cloud services	France	Not AI
Citadel AI Inc.	Software Development/Cloud services	Japan	Not AI
Citronics	Information technologies	Belgium	Not AI
City of Dusseldorf, Office of Economic Development	Government/Public institutions	Germany	Not AI
Clarinox	Software Development/Cloud services	Australia	Not AI
CLASSQUIZ	HR/Training/Education	Tunisia	AI
clavata Inc.	Consumer goods/Retail/E-commerce	korearepublicof	AI
CleanMob	Mobility/Transportation	France	Not AI
Cleed.ai	Consumer goods/Retail/E-commerce	France	AI
CLEM'	Mobility/Transportation	France	Not AI
Clever Cloud	Software Development/Cloud services	France	Not AI
CleverValues	Software Development/Cloud services	France	Not AI
Cleyrop	Software Development/Cloud services	France	Not AI
Cleyrop	Software Development/Cloud services	France	Not AI
Clhynn	Energy	France	Not AI
CLICK THERAPEUTICS	Health	United States of America	Not AI
clikOdoc	Health	France	Not AI
Climate Standard	Other	Italy	Not AI
ClimateCamp	Information technologies	Luxembourg	Not AI
Climbo	Marketing/Advertising/Communication	Italy	Not AI
Climeet	Other	France	Not AI
Clinic Home	Health	Cameroon	Not AI
ClipFix	Other	Armenia	Not AI
Cloud Data Engine	Software Development/Cloud services	France	Not AI
Cloud Data Engine	Software Development/Cloud services	France	Not AI
Cloud Inspire	Software Development/Cloud services	France	Not AI
CMA - CGM	Mobility/Transportation	France	Not AI
CNBC	Media/Entertainment/Culture	United States of America	AI
CNN	Media/Entertainment/Culture	United States of America	AI
CNRS	Other	France	Not AI
CO2BioClean GmbH	Industry	Germany	Not AI
Coachello	HR/Training/Education	France	AI
CoAudit GROUP	Software Development/Cloud services	France	Not AI
COBOD	Smart City/Building	Denmark	Not AI
COCOLIS	Mobility/Transportation	France	Not AI
Cocoparks'	Mobility/Transportation	France	Not AI
Codalio	Software Development/Cloud services	Canada	Not AI
Code du Travail Numerique	Government/Public institutions	France	Not AI
Codery	Software Development/Cloud services	Bulgaria	Not AI
codoc	Health	France	Not AI
COEUR-NET	Cybersecurity/Defense	France	Not AI
CogNeed	Software Development/Cloud services	France	Not AI
Cognixion	Health	United States of America	Not AI
Cohort	Consumer goods/Retail/E-commerce	France	AI
COLIBA AFRICA	Other	Cote dÕIvoire	Not AI
ColibriTD	Information technologies	France	Not AI
COLINE CARE	HR/Training/Education	France	AI
Collectivite de Corse I Agence de Developpement Economique de la Corse (ADEC)	Other	France	Not AI
COLORFOL	Media/Entertainment/Culture	Cameroon	AI
COMET	Information technologies	France	Not AI
COMEXI	Industry	Spain	Not AI
COMIN	Mobility/Transportation	France	Not AI
Commissariat General au Developpement Durable	Government/Public institutions	France	Not AI
Commown	Information technologies	France	Not AI
Commute Zen (WeavAir company)	Information technologies	Singapore	Not AI
COMPL'ALIM	Food	France	Not AI
ComplyMarket	Information technologies	Germany	Not AI
COMPOROLL	Food	Tunisia	Not AI
Compredict	Software Development/Cloud services	Germany	Not AI
Compusave	Telecom/Connectivity	Algeria	Not AI
Concours Mines-Telecom	HR/Training/Education	France	AI
Concree	Software Development/Cloud services	Senegal	Not AI
Configreality Technology Limited	Media/Entertainment/Culture	China	AI
Connected Cycle	Mobility/Transportation	France	Not AI
Connectedrealities	Software Development/Cloud services	Poland	Not AI
Contents.com	Information technologies	Italy	Not AI
Contentsquare	Software Development/Cloud services	France	Not AI
Coomtech Ltd	Industry	United Kingdom	Not AI
Coreod Space	Software Development/Cloud services	France	Not AI
Cortex Machina SRL	Health	Belgium	Not AI
Cosmian	Software Development/Cloud services	France	Not AI
COSMO CONNECTED	Mobility/Transportation	France	Not AI
Cosmo Tech	Software Development/Cloud services	France	Not AI
Counterfake AI	Consumer goods/Retail/E-commerce	Turkey	AI
Covoiturage	Mobility/Transportation	France	Not AI
Coyali	Telecom/Connectivity	France	Not AI
COZERO	Software Development/Cloud services	Germany	Not AI
Craftsmen - Software Maestros.	Software Development/Cloud services	Bangladesh	Not AI
CREAGUM	Industry	France	Not AI
Credit Agricole	Banking/Finance/Insurance/Legal	France	Not AI
CREFLE Inc.	Software Development/Cloud services	South Korea	Not AI
CrossCall	Consumer goods/Retail/E-commerce	France	AI
Crowdaa	Software Development/Cloud services	Reunion	Not AI
Crowdworks AI	Information technologies	South Korea	Not AI
CryoCollect SAS	Energy	France	Not AI
CryptoNext Security	Cybersecurity/Defense	France	Not AI
CRYSTALCHAIN	Information technologies	France	Not AI
CSEM SA	Other	Switzerland	Not AI
csky.ai	Information technologies	Switzerland	Not AI
CultTech Association	Media/Entertainment/Culture	Austria	AI
CULTURADVISOR	Media/Entertainment/Culture	France	AI
Culture pieces	Media/Entertainment/Culture	China	AI
Culturius	Media/Entertainment/Culture	Belgium	AI
Cuoncrop	Food	Japan	Not AI
CURE51	Health	France	Not AI
CureCurve Medical AI	Health	Germany	Not AI
CustomsBridge	Information technologies	France	Not AI
cvnavi ______	Industry	China	Not AI
CWS Platform	Software Development/Cloud services	Brazil	Not AI
CYBELETECH	Other	France	Not AI
CYBERSHEN	Cybersecurity/Defense	France	Not AI
CYBERTEC SERVICES S.R.L./COMPUTARTE	Smart City/Building	Italy	Not AI
Cybertron Tech GmbH ________	Industry	China	Not AI
Cynteract GmbH	Health	Germany	Not AI
CypherLab	Information technologies	France	Not AI
Cypien AI	Information technologies	Turkey	Not AI
D-Shape Limited	Smart City/Building	Hong Kong	Not AI
DABIDA Corp.	Smart City/Building	South Korea	Not AI
DAIDALA	Media/Entertainment/Culture	France	AI
Daily Deal	Health	Algeria	Not AI
Dailymotion Pro	Media/Entertainment/Culture	France	AI
Dartfish	Software Development/Cloud services	Switzerland	Not AI
Data Driven	HR/Training/Education	France	AI
Data farms	Food	Canada	Not AI
Data First Solutions	Information technologies	United Arab Emirates	Not AI
Data for Ethic	HR/Training/Education	France	AI
Data Green by Netsooon.AI	Software Development/Cloud services	France	Not AI
Data Monsters	Consumer goods/Retail/E-commerce	South Korea	AI
Data protect	Cybersecurity/Defense	France	Not AI
DataBeez	HR/Training/Education	Senegal	AI
DataGalaxy	Software Development/Cloud services	France	Not AI
Dataiku	Software Development/Cloud services	France	Not AI
Dataiku	Software Development/Cloud services	France	Not AI
Datapred	Software Development/Cloud services	France	Not AI
Datategy	Software Development/Cloud services	France	Not AI
DAVI	Software Development/Cloud services	France	Not AI
Dawex	Information technologies	France	Not AI
Daylindo	HR/Training/Education	France	AI
de:hub digital ecosystems	Government/Public institutions	Germany	Not AI
Dealt	Consumer goods/Retail/E-commerce	France	AI
Deardot	Luxury/Fashion/Beauty	South Korea	Not AI
DeclareDouane	Government/Public institutions	France	Not AI
Deep Life	Health	France	Not AI
DEEP.FINE	Software Development/Cloud services	South Korea	Not AI
DeepHawk	Industry	France	Not AI
DeepHawk	Industry	France	Not AI
Deepixel	Luxury/Fashion/Beauty	South Korea	Not AI
Deepomatic	Software Development/Cloud services	France	Not AI
DeepScent Inc.	Smart City/Building	korearepublicof	Not AI
Deeptimize	Software Development/Cloud services	France	Not AI
Deesup	Consumer goods/Retail/E-commerce	Italy	AI
Deki	Mobility/Transportation	France	Not AI
Delarto	Information technologies	Bulgaria	Not AI
Deloitte	Consulting	France	Not AI
DELOITTE AFRICA	Consulting	Tunisia	Not AI
Delos Intelligence	Software Development/Cloud services	France	Not AI
DELPHINE GENIN - Virtual Atelier	Luxury/Fashion/Beauty	Australia	Not AI
deltaVision GmbH	Industry	Germany	Not AI
DeltaWave	Health	France	Not AI
DELUPAY	Banking/Finance/Insurance/Legal	France	Not AI
DemandHigh	Marketing/Advertising/Communication	Bulgaria	Not AI
Demet Air	Smart City/Building	France	Not AI
DEMREA FRANCE	Smart City/Building	France	Not AI
DENERGIUM	Software Development/Cloud services	France	Not AI
Depist&vous	Health	France	Not AI
DePlano	Banking/Finance/Insurance/Legal	France	Not AI
Design system de l'etat franais	Government/Public institutions	France	Not AI
deskbird	Software Development/Cloud services	Switzerland	Not AI
DESMO PTE.LTD.	Smart City/Building	Singapore	Not AI
Deus Robotics	Software Development/Cloud services	United States of America	Not AI
Deutsch-Franzosische Hochschule / Universite franco-allemande (DFH-UFA)	HR/Training/Education	Germany	AI
Deutsches Forschungszentrum fr Knstliche Intelligenz DFKI	Information technologies	Germany	Not AI
Devana	Software Development/Cloud services	France	Not AI
Devanthro	Health	Germany	Not AI
Dexter	Energy	Netherlands	Not AI
Dextrain	Health	France	Not AI
DFI	Marketing/Advertising/Communication	France	Not AI
DGDDI -3D	Government/Public institutions	France	Not AI
DGSE	Government/Public institutions	France	Not AI
DiaDeep	Health	France	Not AI
Diagante	Health	France	Not AI
DIAGANTE	Health	France	Not AI
Diagoriente	Government/Public institutions	France	Not AI
Diagrams technologies	Software Development/Cloud services	France	Not AI
DiagRAMS Technologies	Software Development/Cloud services	France	Not AI
DIAM CONCEPT	Luxury/Fashion/Beauty	France	Not AI
DIAMSENS	Consumer goods/Retail/E-commerce	France	AI
Didask	HR/Training/Education	France	AI
DIGIBARRE	Information technologies	New Caledonia	Not AI
Digital Bangladesh	Government/Public institutions	Bangladesh	Not AI
DIGITAL PROGRAM FOR ADHD FAMILIES	Health	France	Not AI
Digital Substrate	Information technologies	France	Not AI
DIGITALANDMARKS	Marketing/Advertising/Communication	France	Not AI
Digiteal	Banking/Finance/Insurance/Legal	Belgium	Not AI
DinMo	Software Development/Cloud services	France	Not AI
Dionymer	Industry	France	Not AI
Direction de la Transformation Numerique du ministere de lÕInterieur et des Outre-mer	Other	France	Not AI
Direction du Numerique du ministere du Travail, de la Sante et des Solidarites	Government/Public institutions	France	Not AI
Direction generale de lÕadministration et de la fonction publique	Government/Public institutions	France	Not AI
Direction interministerielle de la Transformation publique	Government/Public institutions	France	Not AI
Direction interministerielle du Numerique (DINUM)	Government/Public institutions	France	Not AI
Discuss&Care	Health	France	Not AI
Djamo	Banking/Finance/Insurance/Legal	Cote dÕIvoire	Not AI
Djoli	Consumer goods/Retail/E-commerce	Cote dÕIvoire	AI
DK	Marketing/Advertising/Communication	France	Not AI
DLM Soft	Information technologies	France	Not AI
DNC Information Management GmbH	Software Development/Cloud services	Germany	Not AI
Docent	Media/Entertainment/Culture	France	AI
Docusign	Information technologies	France	Not AI
Domethics srl	Health	Italy	Not AI
Domifa	Government/Public institutions	France	Not AI
Dongguan Yuanguan Technology Co Ltd	Industry	China	Not AI
Dopavision	Health	Germany	Not AI
DossierFacile	Government/Public institutions	France	Not AI
Douzzie	HR/Training/Education	France	AI
DPEProd	Information technologies	France	Not AI
DRACOSS	Energy	Tunisia	Not AI
Draft & Goal	Software Development/Cloud services	Canada	Not AI
Dreaminzzz	Health	France	Not AI
DRESSX	Luxury/Fashion/Beauty	United States of America	Not AI
DriiveMe	Mobility/Transportation	France	Not AI
Drilllight	Health	France	Not AI
DROIMAGE	Marketing/Advertising/Communication	France	Not AI
DroMii Co., Ltd.	Information technologies	South Korea	Not AI
Droople	Smart City/Building	Switzerland	Not AI
DS PERFORMANCE	Mobility/Transportation	France	Not AI
DSG.AI	Banking/Finance/Insurance/Legal	Germany	Not AI
DT Master Carbon	Software Development/Cloud services	France	Not AI
Dubai Department of Economy and Tourism	Government/Public institutions	United Arab Emirates	Not AI
DUCKMA SRL	Software Development/Cloud services	Italy	Not AI
DUKE	Software Development/Cloud services	Reunion	Not AI
DUST	Information technologies	France	Not AI
DWS	Luxury/Fashion/Beauty	France	Not AI
Dydu	Telecom/Connectivity	France	Not AI
Dyjest	Health	France	Not AI
Dynamo S.p.A	Information technologies	Italy	Not AI
e-BMDC	Cybersecurity/Defense	France	Not AI
Earthian AI	Banking/Finance/Insurance/Legal	Netherlands	Not AI
EASY PEASY INSURTECH	Banking/Finance/Insurance/Legal	Ukraine	Not AI
EasyDMARC	Cybersecurity/Defense	Armenia	Not AI
EBIOSE	Information technologies	France	Not AI
Ecal	Media/Entertainment/Culture	Australia	AI
EcoBarter	Other	Nigeria	Not AI
Ecohesens	Health	France	Not AI
ecole des dirigeants HEC Montreal	Government/Public institutions	Canada	Not AI
ecollant	Industry	France	Not AI
Ecomesure	Information technologies	France	Not AI
EcoNautik	Mobility/Transportation	France	Not AI
ECTOR	Hospitality/Tourism/Travel	France	Not AI
EDF	Energy	France	Not AI
Edgeless Systems	Cybersecurity/Defense	Germany	Not AI
Edhec Entrepreneurs	Other	France	Not AI
EDMAPS	Information technologies	Ukraine	Not AI
EDONIA	Food	France	Not AI
EF Polymer K.K.	Industry	Japan	Not AI
Effa	Consumer goods/Retail/E-commerce	United States of America	AI
Effixis	Consulting	Belgium	Not AI
EFPolymer	Industry	Japan	Not AI
Egonym	Information technologies	Switzerland	Not AI
EHLeague, Hotels Club by TiCATi.com	Hospitality/Tourism/Travel	France	Not AI
EHP2	Mobility/Transportation	France	Not AI
eiicon co.,ltd	Other	Japan	Not AI
EIKO	Non Profit	France	Not AI
EISOX	Smart City/Building	France	Not AI
Ekimetrics	Information technologies	France	Not AI
Ekimetrics	Information technologies	France	Not AI
EKLEER	Information technologies	South Korea	Not AI
ELA Innovation	Information technologies	France	Not AI
ELDA TECHNOLOGY	Software Development/Cloud services	France	Not AI
Electra	Mobility/Transportation	France	Not AI
electric Oasis	Mobility/Transportation	France	Not AI
Electrochaea GmbH	Energy	Germany	Not AI
Elementag	Industry	Italy	Not AI
Elephantech Inc.	Industry	Japan	Not AI
Elikya Therapeutics	Health	France	Not AI
ELIO SAS	HR/Training/Education	France	AI
Eliq	Energy	Sweden	Not AI
Elixir Health	Health	France	Not AI
Ellipse	Industry	United States of America	Not AI
Elona Health	Health	Germany	Not AI
elow	Energy	France	Not AI
Elpyoo	HR/Training/Education	France	AI
Elysium Lab	Banking/Finance/Insurance/Legal	Switzerland	Not AI
Embassy of Brazil in Paris	Government/Public institutions	Brazil	Not AI
Embie	Software Development/Cloud services	Belgium	Not AI
EMCT CO., LTD.	Software Development/Cloud services	South Korea	Not AI
Emocio	HR/Training/Education	France	AI
Emperia	Software Development/Cloud services	United Kingdom	Not AI
Emsense	Mobility/Transportation	Sweden	Not AI
Emulsion Flow Technologies Ltd.	Mobility/Transportation	Japan	Not AI
Emvista	Banking/Finance/Insurance/Legal	France	Not AI
Emvista	Banking/Finance/Insurance/Legal	France	Not AI
En 1 Clic	Software Development/Cloud services	France	Not AI
Enchanted Tools	Industry	France	Not AI
Encorp.io	Software Development/Cloud services	Bulgaria	Not AI
Enead	Smart City/Building	France	Not AI
ENEDIS	Energy	France	Not AI
Energiency	Software Development/Cloud services	France	Not AI
Energy Robotics	Software Development/Cloud services	Germany	Not AI
EnergySage.fr	Energy	France	Not AI
ENERSENS	Mobility/Transportation	France	Not AI
ENERTIME	Energy	France	Not AI
ENFANT DU NORD	Luxury/Fashion/Beauty	France	Not AI
ENGIE	Energy	France	Not AI
ENGIE - REIDS SPORE	Energy	Singapore	Not AI
ENGIE Green	Energy	France	Not AI
ENGIE Laborelec	Energy	Belgium	Not AI
ENGIE Mon Pilotage Elec	Energy	France	Not AI
ENGIE Mon Pilotage Gaz	Energy	France	Not AI
ENGIE Smart Home - Ma conso +	Energy	France	Not AI
ENGIE Vianeo	Mobility/Transportation	France	Not AI
Enhancy (Miroa )	Consumer goods/Retail/E-commerce	France	AI
Enhywhere	Mobility/Transportation	France	Not AI
ENNEA GROUPE	Industry	France	Not AI
Enode	Energy	Norway	Not AI
ENOT.ai	Mobility/Transportation	Luxembourg	Not AI
Enqura	Banking/Finance/Insurance/Legal	Turkey	Not AI
Enrich in Africa Center	Consulting	South Africa	Not AI
enso rse	Software Development/Cloud services	France	Not AI
ensogo Inc.	Software Development/Cloud services	Canada	Not AI
Enspired	Energy	Austria	Not AI
Ensweet	Health	France	Not AI
ENSWEET	Health	France	Not AI
ENTENT	Energy	France	Not AI
Enterprise Armenia	Government/Public institutions	Armenia	Not AI
Entrix	Energy	Germany	Not AI
Entropy	Mobility/Transportation	France	Not AI
Entroview	Software Development/Cloud services	France	Not AI
Environmental & Human Technologies	Health	United States of America	Not AI
Eoliann S.R.L. Societa' Benefit	Banking/Finance/Insurance/Legal	Italy	Not AI
EONA-X data space	Mobility/Transportation	France	Not AI
Epago Technologies Limited	Energy	Hong Kong	Not AI
ePhantom	Information technologies	France	Not AI
Epic Algeria venture	Government/Public institutions	Algeria	Not AI
Epicnpoc	Mobility/Transportation	France	Not AI
EPOCA	Health	France	Not AI
EPSEED	Information technologies	France	Not AI
EQL	Consumer goods/Retail/E-commerce	Australia	AI
EquaTalent	HR/Training/Education	France	AI
Equip	Other	Switzerland	Not AI
Eratos	Information technologies	Australia	Not AI
ERGOSANTe / HAPO	Industry	France	Not AI
ERMES CYBER SECURITY S.p.A.	Cybersecurity/Defense	Italy	Not AI
Esencia Foods	Food	Germany	Not AI
ESIEE Paris	HR/Training/Education	France	AI
ESPER	Media/Entertainment/Culture	France	AI
Esper Bionics	Health	United States of America	Not AI
ESTEPS	Health	United States of America	Not AI
Estonie - Ambassade d'Estonie	Government/Public institutions	Estonia	Not AI
ETALAB	Information technologies	France	Not AI
ETEOS	Software Development/Cloud services	France	Not AI
Eternal Power GmbH	Energy	Germany	Not AI
Ether Impact	Consulting	France	Not AI
Ethic First	Consulting	France	Not AI
EthonAI AG	Industry	Switzerland	Not AI
ETHYLOWHEEL	Mobility/Transportation	France	Not AI
ETIKL	Banking/Finance/Insurance/Legal	France	Not AI
eTreego Co., Ltd.	Mobility/Transportation	Taiwan	Not AI
ETSEME	Information technologies	France	Not AI
ETSOL Engineering	Smart City/Building	France	Not AI
Etudesk	HR/Training/Education	Cote dÕIvoire	AI
Euglena Co., Ltd.	Industry	Japan	Not AI
Euractiv	Media/Entertainment/Culture	Belgium	AI
Eurailscout France	Mobility/Transportation	France	Not AI
Euronews	Media/Entertainment/Culture	France	AI
European Commission - DG Connect	Government/Public institutions	Belgium	Not AI
European innovation Council - EIC	Government/Public institutions	Belgium	Not AI
European Patent Office	Government/Public institutions	Germany	Not AI
Ev.Tech	Energy	Cote dÕIvoire	Not AI
evendsa	Media/Entertainment/Culture	Germany	AI
Everdian	Cybersecurity/Defense	France	Not AI
EVERFLY	Food	France	Not AI
EveryHuman	Luxury/Fashion/Beauty	Netherlands	Not AI
Evrotrust		Bulgaria	Not AI
EWAKE GERMANY GmbH	Consumer goods/Retail/E-commerce	Germany	AI
EX9	Mobility/Transportation	France	Not AI
EX9	Mobility/Transportation	France	Not AI
Exaion	Software Development/Cloud services	France	Not AI
Exhalon.io	Health	France	Not AI
Exnaton	Energy	Germany	Not AI
Expando	Marketing/Advertising/Communication	Hong Kong	Not AI
Experience Abu Dhabi	Hospitality/Tourism/Travel	United Arab Emirates	Not AI
Explor.ai	Software Development/Cloud services	Canada	Not AI
Explore Media	Media/Entertainment/Culture	France	AI
Expo Favela Paris - CUFA	Non Profit	Brazil	Not AI
EY	Consulting	United Kingdom	Not AI
EYAKO	Cybersecurity/Defense	Reunion	Not AI
Eye-Net	Mobility/Transportation	Israel	Not AI
Eyesoft	Health	France	Not AI
Ezymob	Mobility/Transportation	France	Not AI
EZYMOB	Mobility/Transportation	France	Not AI
F8th Inc.	Cybersecurity/Defense	Canada	Not AI
FabNum des Ministeres Sociaux	Government/Public institutions	France	Not AI
Fabriq	Software Development/Cloud services	France	Not AI
Fabstwines	Food	Luxembourg	Not AI
FaceHeart Corporation	Health	Taiwan	Not AI
Facil'iti	Marketing/Advertising/Communication	France	Not AI
Factoryz	Software Development/Cloud services	France	Not AI
FAIR VISION	Information technologies	France	Not AI
FAIRLYNE	Software Development/Cloud services	France	Not AI
FAIRME	Food	France	Not AI
FAIRPLAYER	Marketing/Advertising/Communication	France	Not AI
FAME	Consumer goods/Retail/E-commerce	France	AI
Famoco	Software Development/Cloud services	France	Not AI
FANarZONE	Media/Entertainment/Culture	France	AI
FancyTech	Marketing/Advertising/Communication	China	Not AI
Farm to Feed		Kenya	Not AI
Farm3	Food	France	Not AI
Farmer Lifeline Technologies	Food	Kenya	Not AI
Farpoint Technologies	Consulting	Canada	Not AI
FASEYA - YATOUZE	Software Development/Cloud services	France	Not AI
Fast Delivery	Food	Algeria	Not AI
Fastecx	Information technologies	Japan	Not AI
FastexVerse	Information technologies	Armenia	Not AI
FASTPOINT	Industry	France	Not AI
FastSpring	Consumer goods/Retail/E-commerce	United States of America	AI
FAVA / INTIM'ED	Consumer goods/Retail/E-commerce	France	AI
FEELBAT	Smart City/Building	Reunion	Not AI
FEELBAT	Smart City/Building	France	Not AI
FEELOBJECT	Smart City/Building	France	Not AI
Female Founder Challenge	Other	France	Not AI
FemTech France	Health	France	Not AI
Fentech	Information technologies	France	Not AI
FIDELATOO	Consumer goods/Retail/E-commerce	France	AI
Fifteen	Mobility/Transportation	France	Not AI
Fifth Wall Immersive Media Lab	Media/Entertainment/Culture	United Arab Emirates	AI
FileOrbis	Software Development/Cloud services	Turkey	Not AI
FILIZ	HR/Training/Education	France	AI
FILTRALIFE	Industry	France	Not AI
Financial Times	Media/Entertainment/Culture	United Kingdom	AI
FINAPP SRL	Energy	Italy	Not AI
FINDS	Luxury/Fashion/Beauty	France	Not AI
Finense	Banking/Finance/Insurance/Legal	France	Not AI
FININFO SOUTIONS	Banking/Finance/Insurance/Legal	Tunisia	Not AI
FINOVOX	Software Development/Cloud services	France	Not AI
Firefly Fusion	Energy	France	Not AI
FireTracking	Government/Public institutions	France	Not AI
FireTracking	Government/Public institutions	France	Not AI
FiveBrane	Health	United States of America	Not AI
FKM MOBILITE SAS	Mobility/Transportation	France	Not AI
flameUp	Software Development/Cloud services	France	Not AI
FLAXIB	Mobility/Transportation	Reunion	Not AI
Flex System Co., Ltd.	Health	South Korea	Not AI
Flex-e	Energy	France	Not AI
FlexLedLight	Marketing/Advertising/Communication	France	Not AI
Flight Buddy	Mobility/Transportation	Germany	Not AI
Flipjungle LAB	Information technologies	South Korea	Not AI
Fliption Inc	Marketing/Advertising/Communication	United States of America	Not AI
Flit Run	Other	France	Not AI
FLOATEE	Health	France	Not AI
FLOATEE	Health	France	Not AI
FLOATING GENES	Health	France	Not AI
Flouci	Banking/Finance/Insurance/Legal		Not AI
FLOWARE	Smart City/Building	France	Not AI
Flowie	Banking/Finance/Insurance/Legal	France	Not AI
Fluctuo	Mobility/Transportation	France	Not AI
fluiidd	Industry	France	Not AI
FLYCOPTER PROJECT SAS	Industry	France	Not AI
FLYING WHALES	Mobility/Transportation	France	Not AI
Flywallet	Health	Italy	Not AI
FNAC DARTY	Consumer goods/Retail/E-commerce	France	AI
FOGO	Industry	France	Not AI
Follow Inspiration	Industry	Portugal	Not AI
Follower Products	Cybersecurity/Defense	France	Not AI
Food Analytics	Food	France	Not AI
Food Pilot	Software Development/Cloud services	France	Not AI
FOOD4FUTURE	Consumer goods/Retail/E-commerce	Tunisia	AI
Foodelles	Health	France	Not AI
FOOTBAR	Information technologies	France	Not AI
Footsider	Personal Services	France	Not AI
Forciot Oy	Mobility/Transportation	Finland	Not AI
Forekasts	Software Development/Cloud services	France	Not AI
Fortune Media	Media/Entertainment/Culture	United States of America	AI
FOSINA	Mobility/Transportation	France	Not AI
FOVIATECH GmbH	Information technologies	Germany	Not AI
Foxar	HR/Training/Education	France	AI
FR-Alert	Government/Public institutions	France	Not AI
FRACTAL ENERGY	Energy	France	Not AI
France 2030	Government/Public institutions	France	Not AI
France Medias Monde	Media/Entertainment/Culture	France	AI
France Quadricycle	Mobility/Transportation	France	Not AI
FRANCE TELEVISIONS	Media/Entertainment/Culture	France	AI
FRANCE TRAVAIL	Government/Public institutions	France	Not AI
France VAE	Government/Public institutions	France	Not AI
Franceinfo	Media/Entertainment/Culture	France	AI
FREEPLACE	Mobility/Transportation	France	Not AI
French General Secretariat for Investment, France 2030	Government/Public institutions	France	Not AI
French German Tech Lab / Germany	Government/Public institutions	Germany	Not AI
French Korean Chamber of Commerce and Industry (FKCCI)	Non Profit	korearepublicof	Not AI
French State's Digital Space	Government/Public institutions	France	Not AI
French Tech	Government/Public institutions	France	Not AI
French Tech Grand Paris	Other	France	Not AI
French Tech Guadeloupe	Other	Guadeloupe	Not AI
French Tech Guyane		France	Not AI
French Tech Martinique	Non Profit	France	Not AI
French tech Mayotte	Information technologies	Mayotte	Not AI
FRENCH TECH REUNION	Other	Reunion	Not AI
French Touch Factory	Software Development/Cloud services	France	Not AI
Freshworks	Software Development/Cloud services	United States of America	Not AI
FRIMITY	Media/Entertainment/Culture	France	AI
Fringuant	Consumer goods/Retail/E-commerce	France	AI
FROGANS	Information technologies	France	Not AI
Fruggr	Software Development/Cloud services	France	Not AI
Fruggr	Software Development/Cloud services	France	Not AI
Fujitsu Limited	Information technologies	Japan	Not AI
fulfin	Banking/Finance/Insurance/Legal	Germany	Not AI
FULLSOON	Food	France	Not AI
Funartech	Information technologies	Canada	Not AI
FUNGFEED	Industry	France	Not AI
Fungu'it	Food	France	Not AI
Futura	Media/Entertainment/Culture	France	AI
FUTURE FASHION S.R.L.	Consumer goods/Retail/E-commerce	Italy	AI
Futurewave	Other	Belgium	Not AI
Fylia	Media/Entertainment/Culture	France	AI
GALENICA.ai	Health	Mozambique	Not AI
Gamino	HR/Training/Education	France	AI
Gapianne	Health	France	Not AI
Gare ta Becane	Smart City/Building	France	Not AI
GasNas	Energy	Jordan	Not AI
GazoTech	Energy	France	Not AI
GCollect	Banking/Finance/Insurance/Legal	France	Not AI
Gcore	Software Development/Cloud services	Luxembourg	Not AI
Gedeon	Banking/Finance/Insurance/Legal	France	Not AI
GEEIQ	Marketing/Advertising/Communication	United Kingdom	Not AI
Genera	Software Development/Cloud services	Ukraine	Not AI
